.....................#
.#########.#########.#
.....................#
.#########.#########.#
.....................#
.#########.#########.#
.....................#
.#########.#########.#
......................
.#########.#########.#
.....................#
.#########.#########.#
.....................#
.#########.#########.#
.....................#
.#########.#########.#
.....................#