######..##
######....
######....
..........
..........
.###.###..
.###.###..
.#.#......
..........
..........