...#...#...#...
.#.#.#.#.#.#.#.
.#.#.#.#.#.#.#.
...............
.#.#.#.#.#.#.#.
.#.#.#.#.#.#.#.
.#.#.#.#.#.#.#.